#######################################################################
#######################################################################
######     ##   #####      ##        ###        ###   ###   ###   #####
####   #   ##   #####   ######   ##   ####   ####   ####    #####   ###
###   ##   ##   #####   ######   ##   ####   ####   ###     #####   ###
###        ##   ###        ###      ######   ####   #####   #####   ###
###   ##   ##   #####   ######   ##   ####   ####   #####   #####   ###
###   ##   ##      ##       ##   ###   ###   ######   ###   ###   #####
#######################################################################
#######################################################################